9,9,9,9,9,9,9,9,9,9,9,9,9,9,9,9,9,9,9,9,9,9,9,9,9,9,9,9,9,9,9,9,9,9,9,9,9,9,9,9,9,9,9,9,9,9,9,9,9,9,9,9,9,9,9,9,9,9,9,9,9,9,9,9
9,0,0,0,0,0,0,0,0,0,0,0,0,0,0,0,0,0,0,0,0,0,0,0,0,0,0,0,0,0,0,0,0,0,0,0,0,0,0,0,0,0,0,0,0,0,0,0,0,0,0,0,0,0,0,0,0,0,0,0,0,0,0,9
9,0,0,0,0,0,0,0,0,0,0,0,0,0,0,0,0,0,0,0,0,0,0,0,0,0,0,0,0,0,0,0,0,0,0,0,0,0,0,0,0,0,0,0,0,0,0,0,0,0,0,0,0,0,0,0,0,0,0,0,0,0,0,9
9,0,0,0,0,0,0,0,0,0,0,0,0,0,0,0,0,0,0,0,0,0,0,0,0,0,2,0,0,0,0,0,0,0,0,0,0,2,0,0,0,0,0,0,0,0,0,0,0,0,0,0,0,0,0,0,0,0,0,0,0,0,0,9
9,0,0,0,2,0,0,0,0,0,0,0,0,0,0,2,2,2,2,2,2,2,0,0,0,0,2,0,0,0,0,0,0,0,0,0,0,2,0,0,0,0,2,2,2,2,2,2,2,0,0,0,0,0,0,0,0,0,0,2,0,0,0,9
9,0,0,0,2,0,0,0,0,0,0,0,0,0,0,2,0,0,0,0,0,2,0,0,0,0,2,0,0,0,0,0,0,0,0,6,0,3,0,0,0,0,2,0,0,0,0,4,2,0,0,0,0,0,0,0,0,0,0,2,0,0,0,9
9,0,0,0,2,0,0,0,0,0,0,0,0,0,0,3,0,0,2,0,0,2,0,0,0,0,2,0,0,0,0,2,0,0,0,0,0,3,0,0,0,0,2,0,0,2,0,0,3,0,0,0,0,0,0,0,0,0,0,2,0,0,0,9
9,0,0,0,2,0,0,0,0,0,0,0,0,0,0,3,0,0,2,0,2,2,0,0,0,0,2,0,7,0,0,2,0,0,0,0,0,3,0,0,0,0,2,0,0,2,0,0,3,0,0,0,0,0,0,0,0,0,0,2,0,0,0,9
9,0,0,0,2,0,0,0,0,0,0,0,0,0,0,3,0,0,0,0,0,3,0,0,0,0,3,0,0,0,0,2,0,0,0,0,0,2,0,0,0,0,2,2,0,0,0,0,3,0,0,0,0,0,0,0,0,0,0,2,0,0,0,9
9,0,0,0,2,0,0,0,0,0,0,0,0,0,0,2,2,0,0,0,0,3,0,0,0,0,3,0,0,0,2,2,2,0,0,2,2,2,0,0,0,0,3,0,0,0,0,2,2,0,0,0,0,0,0,0,0,0,0,2,0,0,0,9
9,0,0,0,2,2,2,2,2,2,0,0,0,0,0,2,0,0,2,0,0,2,0,0,0,0,3,0,0,0,2,2,2,0,0,2,2,2,0,0,0,0,3,0,0,2,0,0,2,0,0,0,0,0,2,2,2,2,2,2,0,0,0,9
9,0,0,0,2,0,0,0,0,3,0,0,0,0,0,0,0,0,2,0,0,2,0,0,0,0,2,2,2,0,2,2,2,0,0,0,0,2,0,0,0,0,2,0,0,2,0,0,0,0,0,0,0,0,3,0,0,0,0,2,0,0,0,9
9,0,0,0,2,0,0,0,0,3,0,0,0,0,0,0,0,0,2,0,0,2,0,0,0,0,2,2,2,0,2,2,2,0,0,0,0,2,0,0,0,0,2,0,0,2,0,0,0,0,0,0,0,0,3,0,0,0,0,2,0,0,0,9
9,0,0,0,2,0,0,6,0,3,0,0,0,0,0,0,0,0,2,0,0,0,0,0,0,0,2,0,0,0,3,5,3,0,0,0,0,2,0,0,0,0,0,0,0,2,0,0,0,0,0,0,0,0,3,0,6,0,0,2,0,0,0,9
9,0,0,0,2,0,0,0,0,3,0,0,0,0,0,0,0,2,2,2,0,0,0,0,0,0,2,0,0,0,3,3,3,0,0,0,0,2,0,0,0,0,0,0,2,2,2,0,0,0,0,0,0,0,3,0,0,0,0,2,0,0,0,9
9,0,0,0,2,2,2,3,3,2,2,2,0,0,0,0,0,0,3,0,0,0,0,0,0,0,2,0,0,0,3,3,3,0,0,0,0,2,0,0,0,0,0,0,0,3,0,0,0,0,0,0,2,2,2,3,3,2,2,2,0,0,0,9
9,0,0,0,3,0,0,0,0,0,0,3,0,0,0,0,0,0,3,0,0,0,0,0,0,0,2,0,2,2,3,3,3,2,2,0,0,3,0,0,0,0,0,0,0,3,0,0,0,0,0,0,3,0,0,0,0,0,0,3,0,0,0,9
9,0,0,0,3,0,0,0,7,0,0,3,0,0,0,2,2,3,2,3,2,2,0,0,0,0,2,0,2,2,3,8,3,2,2,0,0,3,0,0,0,0,2,2,3,2,3,2,2,0,0,0,3,0,0,7,0,0,0,3,0,0,0,9
9,0,0,0,3,0,0,0,0,0,0,3,0,0,0,0,0,0,3,0,0,0,0,0,0,0,3,0,2,2,3,3,3,2,2,0,0,3,0,0,0,0,0,0,0,3,0,0,0,0,0,0,3,0,0,0,0,0,0,3,0,0,0,9
9,0,0,0,2,2,2,3,3,2,2,2,0,0,0,0,0,0,3,0,0,0,0,0,0,0,3,0,0,0,3,3,3,0,0,0,0,3,0,0,0,0,0,0,0,3,0,0,0,0,0,0,2,2,2,3,3,2,2,2,0,0,0,9
9,0,0,0,2,0,0,0,0,3,0,0,0,0,0,0,0,2,2,2,0,0,0,0,0,0,3,0,0,0,3,3,3,0,0,0,0,2,0,0,0,0,0,0,2,2,2,0,0,0,0,0,0,0,3,0,0,0,0,2,0,0,0,9
9,0,0,0,2,0,0,6,0,3,0,0,0,0,0,0,0,0,2,0,0,0,0,0,0,0,2,0,0,0,3,5,3,0,0,0,0,2,0,0,0,0,0,0,0,2,0,0,0,0,0,0,0,0,3,0,6,0,0,2,0,0,0,9
9,0,0,0,2,0,0,0,0,3,0,0,0,0,0,0,0,0,3,0,0,2,0,0,0,0,2,0,0,0,2,2,2,0,0,0,0,2,0,0,0,0,2,0,0,2,0,0,0,0,0,0,0,0,3,0,0,0,0,2,0,0,0,9
9,0,0,0,2,0,0,0,0,3,0,0,0,0,0,0,0,0,3,0,0,2,0,0,0,0,2,0,0,0,2,2,2,0,0,7,0,2,0,0,0,0,2,0,0,2,0,0,0,0,0,0,0,0,3,0,0,0,0,2,0,0,0,9
9,0,0,0,2,2,2,2,2,2,0,0,0,0,0,2,0,0,2,0,0,3,0,0,0,0,2,0,6,0,2,2,2,0,0,0,0,3,0,0,0,0,3,0,0,2,0,0,2,0,0,0,0,0,2,2,2,2,2,2,0,0,0,9
9,0,0,0,2,0,0,0,0,0,0,0,0,0,0,2,2,0,2,0,0,3,0,0,0,0,2,0,0,0,0,2,0,0,0,0,0,3,0,0,0,0,3,0,0,2,0,2,2,0,0,0,0,0,0,0,0,0,0,2,0,0,0,9
9,0,0,0,2,0,0,0,0,0,0,0,0,0,0,3,0,0,0,0,2,2,0,0,0,0,3,0,0,0,0,2,0,0,0,0,0,2,0,0,0,0,2,2,0,0,0,0,3,0,0,0,0,0,0,0,0,0,0,2,0,0,0,9
9,0,0,0,2,0,0,0,0,0,0,0,0,0,0,3,0,0,0,0,0,2,0,0,0,0,3,0,0,0,0,2,0,2,2,2,0,2,0,0,0,0,2,0,0,0,0,0,3,0,0,0,0,0,0,0,0,0,0,2,0,0,0,9
9,0,0,0,2,0,0,0,0,0,0,0,0,0,0,3,0,0,2,0,0,2,0,0,0,0,3,0,0,0,0,0,0,2,2,2,0,3,0,0,0,0,2,0,0,2,0,0,3,0,0,0,0,0,0,0,0,0,0,2,0,0,0,9
9,0,0,0,2,0,0,0,0,0,0,0,0,0,0,2,0,0,2,0,0,2,0,0,0,0,2,0,2,2,0,0,0,0,0,0,0,3,0,0,0,0,2,0,0,2,0,0,2,0,0,0,0,0,0,0,0,0,0,2,0,0,0,9
9,0,0,0,2,0,0,0,0,0,0,0,0,0,0,2,0,0,2,0,4,2,0,0,0,0,2,0,2,2,0,0,0,0,0,0,0,3,0,0,0,0,2,0,0,2,0,0,2,0,0,0,0,0,0,0,0,0,0,2,0,0,0,9
9,0,0,0,2,0,0,0,0,0,0,0,0,0,0,2,2,2,2,2,2,2,0,0,0,0,2,0,0,0,0,0,0,0,0,0,0,2,0,0,0,0,2,2,2,2,2,2,2,0,0,0,0,0,0,0,0,0,0,2,0,0,0,9
9,0,0,0,0,0,0,0,0,0,0,0,0,0,0,0,0,0,0,0,0,0,0,0,0,0,2,0,0,0,0,0,0,0,0,0,0,2,0,0,0,0,0,0,0,0,0,0,0,0,0,0,0,0,0,0,0,0,0,0,0,0,0,9
9,0,0,0,0,0,0,0,0,0,0,0,0,0,0,0,0,0,0,0,0,0,0,0,0,0,0,0,0,0,0,0,0,0,0,0,0,0,0,0,0,0,0,0,0,0,0,0,0,0,0,0,0,0,0,0,0,0,0,0,0,0,0,9
9,0,0,0,0,0,0,0,0,0,0,0,0,0,0,0,0,0,0,0,0,0,0,0,0,0,0,0,0,0,0,0,0,0,0,0,0,0,0,0,0,0,0,0,0,0,0,0,0,0,0,0,0,0,0,0,0,0,0,0,0,0,0,9
9,9,9,9,9,9,9,9,9,9,9,9,9,9,9,9,9,9,9,9,9,9,9,9,9,9,9,9,9,9,9,9,9,9,9,9,9,9,9,9,9,9,9,9,9,9,9,9,9,9,9,9,9,9,9,9,9,9,9,9,9,9,9,9
